+--------------------------------------------------+
|~~~~~~~~~~~~~~~~~~~~~~~~~~~~~~~~~~~~~~~~~~~~~~~~~~|
|~~~~~~~~~~~~~~~~~~~~~~~~~~~~~~~~~~~~~~~~~~~~~~~~~~|
|~~~@~~~~~~~~~~~~~~~~~~~~~~~~~~~~~~~~~~~~~~~~~~~~~~|
|~~~~@~~~~~~~~~~~~~~~@~~~~~~@~~~~~~~~~~~~~~~~~~~~~~|
|~~~~~@~~~~~~~~~~~~~~~@~~~~~~~~~~~~~~~~~~~~~~~~~~~~|
|~~~~~~@~~~~~~~~~~~~~~~@~~~~@@@@@@@@@@@@~~~~~~~~~~~|
|~~~~~~~@~~~~~~~~~~~~~~~@~~~~~~~~~~~~~~~~~~~~~~~~@~|
|~~~~~~~~@~~~~~~~~~@~~~~~@~~~~~~~~~~~~~~~~~~~~~~~~~|
|~~@~~~~~~@~~~~~~~~~@~~~~~@~~~~~~~~~~~~~~~~~~~~~~~~|
|~~~@~~~~~~@~~~~~~~~~@~~~~~@~~~~~~~~~~~~~~~~~~~~~~~|
|~~~~@~~~~~~@~~~~~~~~~@~~~~~@~~~~~~~~~~~~~~~~~~~~~~|
|~~~~~@~~~~~~@~~~~~~~~~@~~~~~@~~~~~~~~~~~~~~~~~~~~~|
|~~~~~~@~~~~~~@~~~~~~~~~@~~~~~@~~~~~~~~~~~~~~~~~~~~|
|~~~~~~~@~~~~~~@~~~~~~~~~@~~~~~@~~~~~~~@@@@@~~~~~~~|
|~~~~~~~~@~~~~~~@~~~~~~~~~@~~~~~@~~~~~~~~~~~~~~~~~~|
|~~~~~~~~~@~~~~~~@~~~~~~~~~@~~~~~@~~~~~~~~~~~~~~~~~|
|~~~~~~~~~~@~~~~~~@~~~~~~~~~~~~~~~@~~~~~~~~~~~~~~~~|
|~~~~~~~~~~~@~~~~~~@~~~~~~~~~~~~~~~@~~~~~~~~~~~~~~~|
|~~~~~~~~~~~~@~~~~~~@~~~~~~~~~~~~~~~@~~~~~~~~~~~~~~|
|~~~~~~~~~~~~~@~~~~~~@~~~~~~~~~~~~~~~@~~~~~~~~~~~~~|
|~~~~~~~~~~~~~~~~~~~~~@~~~~~~~~~~~~~~~@~~~~~~~~~~~~|
|~~~~~~~~~~~~~~~~~~~~~~@~~~~~~~~~~~~~~~@~~~~~~~~~~~|
|~~~~~~~~~~~~~~~~~~~~~~~@~~~~~~~~~~~~~~~@~~~~~~~~~~|
|~~~~@~~~~~~~~~~~~~~~~~~~@~~~~~~~~~~~~~~~@~~~~~~~~~|
|~~~~@~~~~~~~~~~~~~~~~~~~~@~~~~~~~~~~~~~~~@~~~~~~~~|
|~~~~@~~~~~~~~~~~~~~~~~~~~~@~~~~~~~~~~~~~~~@~~@@@~~|
|~~~~@~~~~~~~~~~~~~~~~~~~~~~~~~~~~~~~~~~~~~~@~~~~~~|
|~~~~@~~~~~~~~~~~~~~~~~~~~~~~~~~~~~~~~~~~~~~~@~~~~~|
|~~~~@~~~~~~~~~~~~~~~~~~~~~~~~~~~~~~~~~~~~~~~~@~~~~|
|~~~~@~~~~~~~~~~~~~~~~~~~~~~~~~~~~~~~~~~~~~~~~~~~~~|
|~~~~@~~~~~~~~~~~~~~~~~~~~~~~~~~~~~~@~~~~~~~~~~~~~~|
|~~~~@~~~~~@@@@@~~~~~~~~~~~~~~~~~~~~~@~~~~~~~~~~~~~|
|~~~~@~~@~~~~~~~~~~~~@@@@@@@@@@~~~~~~~@~~~~~~~~~~~~|
|~~~~@~~@~@~~~~~~~~~~~~~~~~~~~~~~~~~~~~@~~~~~~~~~~~|
|~~~~@~~@~@~~~~~~~~~~~~~~@~~~~~~~~~~~~~~@~~~~~~~~~~|
|~~~~@~~~~@~~~~~~~~~~~~~~~@~~~~~~~~~~~~~~@~~~~~~~~~|
|~~~~@~~~~@~~~~~~~~~~~~~~~~@~~~~~~~~~~~~~~@~~~~@~~~|
|~~~~@~~~~@~~~~~~~~~~~~~~~~~@~~~~~~~~~~~~~~@~~~~~~~|
|~~~~@~~~~@~~~~~~~~~~~~~~~~~~@~~~~~~~~~~~~~~@~~~~~~|
|~~~~@~~~~@~~~~~~~~~~~~~~~~~~~@~~~~~~~~~~~~~~@~~~~~|
|~~~~@~~~~@~~~~~~~~~~~~~~~~~~~~@~~~~~~~~~~~~~~@~~~~|
|~~~~~~~~~@~~~~~~~~~~~~~~~~~~~~~@~~~~~~~~~~~~~~~~~~|
|~~~~~~~~~~~~~~~~~~~~~@~~~~~~~~~~@~~~~~~~~~~~~~~~~~|
|~~~~~~~~~~~~~~~~~~~~~~~~~~~~~~~~~@~~~~~~~~~~~~~~~~|
|~~~~~~~~~~~~~~~~~~~~~~~~~~~~~~~~~~@~~~~~~~~~~~~~~~|
|~~~~~~~~~~~~~~~~~~~~~~~~@~~~~~~~~~~@~~~~~~~~~~~~~~|
|~~~~~~~~~~~~~~~~~~~~~~~~@~~~~~~~~~~~@~~~~~~~~~~~~~|
|~~~~~~~~~~~~~~~~~~~~~~~~@~~~~~~~~~~~~@~~@@@@@~~~~~|
|~~~~~~~~~~~~~~~~~~~~~~~~@~~~~~~~~~~~~~~~~~~~~~~~~~|
|~~~~~~~~~~~~~~~~~~~~~~~~~~~~~~~~~~~~~~~~~~~~~~~~~~|
+--------------------------------------------------+
