+--------------------+
|                B#  |
|         #      #   |
|  #       #    #    |
|        #  #  #     |
|         #  #       |
|  #       #  #      |
|   #       #  #     |
|    #       #       |
|     #       #      |
|      #       #     |
|       #       #    |
|     #  #   #   #   |
|      #  #       #  |
|       #  #    A    |
|        #  #        |
| #       #          |
| #        #     #   |
|           #  #  #  |
|    ####          # |
|                    |
+--------------------+
