+----------+
|   #  # # |
|    #     |
| A   #    |
|      #   |
|       #  |
|        # |
|    ##    |
|          |
|       #  |
|      B   |
+----------+
