+----------------------------------------------------------------------------------------------------+
|                                                                                                    |
|                                                            ################                        |
|        A                                     #############                                         |
|                                                                                                    |
|                                                                                                    |
|                                                                                                    |
|                                                                                                    |
|                                                                                                    |
|                                                                                                    |
|                 ################################################################                   |
|                                                                                                    |
|                                                                                                    |
|                                                             ######     #                           |
|                                                                         #        #                 |
|                                                                          #        #                |
|                                                                           #        #               |
|                                                                            #        #              |
|                           #                                                 #        #             |
|                           #                                                           #            |
|          #                #                                                            #           |
|          #                #                                                             #          |
|          #                #              #                                               #         |
|          #                #                                                               #        |
|          #                #                                                                #       |
|          #                #       #################        #                                #      |
|          #                #                                 #    #                            #    |
|          #                #                                      #                            #    |
|          #                #                                      #                            #    |
|          #                #                                      #                            #    |
|          #                #                                      #                            #    |
|          #                #                                      #                            #    |
|          #                #                                      #                            #    |
|          #                                                       #                            #    |
|          #                                                       #                            #    |
|          #                                                       #                            #    |
|          #                                                       #                            #    |
|          #                                                                                    #    |
|          #                                              ##############                        #    |
|          #                                                                          #         #    |
|          #                                                                          #         #    |
|          #                                                                          #         #    |
|          #                                                                          #              |
|          #                                                                          #              |
|          #                                                                          #              |
|          #                                                                          #              |
|          #                                                                          #              |
|          #                                                                          #   #          |
|          #                                                                          #    #         |
|          #                                                                          #              |
|          # ################################################################    #    #              |
|          #                                                                     #    #  #  #        |
|          #                                                                     # #                 |
|          #                         #                                           #  #                |
|          #                          #                                          #   #               |
|          #                           #                                              #              |
|          #                            #                                              #             |
|          #                             #                                              #            |
|          #                              #                                              #           |
|          #                                                                                         |
|          #                                                                                         |
|          #            #                                                                            |
|          #            #                                                                            |
|          #            #                                                                            |
|          #            #                   ###########                                              |
|          #            #                                                                            |
|          #            #                                          #                             #   |
|          #            #                                          #      #####                   #  |
|          #            #                                                                          # |
|          #            #                                                                     #      |
|          #            #                                                                      #     |
|          #            #              ####################################################     #    |
|          #            #                                                                        #   |
|                                   ####                           #########                      #  |
|                                                                                                  # |
|                                   #                       #################     ##                 |
|                                    #                                                               |
|                                     #                                                              |
|                                      #                                                             |
|                                       #                                              #   #    #    |
|                                        #                                                 #    #    |
|                                         #                                                #    #    |
|                                          #                                               #         |
|                                           #               #                    #         #         |
|                                            #                                    #        #         |
|                                             #                                    #                 |
|                                              #                                    #                |
|                                                                                                    |
|                   #############################################################################    |
|                                                                                                    |
|                #                                                                                   |
|                #  ###############################           #                ####                  |
|                                                             #                                      |
|                                                                   #                    #         # |
|                                                                   #                    #           |
|                                                                   #                    #        #  |
|                                                                   #                                |
|                                                                               ############         |
|                    ##########################################################                      |
|                                                                                               B    |
|                                                                                                    |
+----------------------------------------------------------------------------------------------------+
