+----------+
|   #  # # |
|    #     |
| A   #    |
| v    #   |
| D     #  |
|  D     # |
|   D##    |
|    D     |
|     D #  |
|      B   |
+----------+