+----------------------------------------------------------------------------------------------------+
|                                                                                                    |
|                                                            ################                        |
|        A\                                    #############                                         |
|          \                                                                                         |
|           \                                                                                        |
|            \                                                                                       |
|             \                                                                                      |
|              \                                                                                     |
|               \                                                                                    |
|                \################################################################                   |
|                 >>>>\                                                                              |
|                      \                                                                             |
|                       \                                     ######     #                           |
|                        \                                                #        #                 |
|                         \                                                #        #                |
|                          \                                                #        #               |
|                           \                                                #        #              |
|                           #v                                                #        #             |
|                           #\                                                          #            |
|          #                # \                                                          #           |
|          #                #  \                                                          #          |
|          #                #   \          #                                               #         |
|          #                #    \                                                          #        |
|          #                #     \                                                          #       |
|          #                #      \#################        #                                #      |
|          #                #       >>>>>>>>>\                #    #                            #    |
|          #                #                 \                    #                            #    |
|          #                #                  \                   #                            #    |
|          #                #                   \                  #                            #    |
|          #                #                    \                 #                            #    |
|          #                #                     \                #                            #    |
|          #                #                      \               #                            #    |
|          #                                        \              #                            #    |
|          #                                         \             #                            #    |
|          #                                          \            #                            #    |
|          #                                           \           #                            #    |
|          #                                            \                                       #    |
|          #                                             \##############                        #    |
|          #                                              >>>>>>>>\                   #         #    |
|          #                                                       \                  #         #    |
|          #                                                        \                 #         #    |
|          #                                                         \                #              |
|          #                                                          \               #              |
|          #                                                           \              #              |
|          #                                                            \             #              |
|          #                                                             \            #              |
|          #                                                              \           #   #          |
|          #                                                               \          #    #         |
|          #                                                                \         #              |
|          # ################################################################v   #    #              |
|          #                                                                 v   #    #  #  #        |
|          #                                                                 v   # #                 |
|          #                         #                                       v   #  #                |
|          #                          #                                      v   #   #               |
|          #                           #                                     v        #              |
|          #                            #                                    v         #             |
|          #                             #                                   \          #            |
|          #                              #                                   \          #           |
|          #                                                                   \                     |
|          #                                                                    \                    |
|          #            #                                                        \                   |
|          #            #                                                         \                  |
|          #            #                                                          \                 |
|          #            #                   ###########                             \                |
|          #            #                                                            \               |
|          #            #                                          #                  \          #   |
|          #            #                                          #      #####        \          #  |
|          #            #                                                               \          # |
|          #            #                                                                \    #      |
|          #            #                                                                 \    #     |
|          #            #              ####################################################v    #    |
|          #            #                                                                  v     #   |
|                                   ####                           #########               v      #  |
|                                                                                          v       # |
|                                   #                       #################     ##       v         |
|                                    #                                                     v         |
|                                     #                                                    v         |
|                                      #                                                   \         |
|                                       #                                              #   #v   #    |
|                                        #                                                 #v   #    |
|                                         #                                                #v   #    |
|                                          #                                               #v        |
|                                           #               #                    #         #\        |
|                                            #                                    #        # \       |
|                                             #                                    #          \      |
|                                              #                                    #          \     |
|                                                                                               \    |
|                   #############################################################################v   |
|                                                                                                v   |
|                #                                                                               v   |
|                #  ###############################           #                ####              v   |
|                                                             #                                  v   |
|                                                                   #                    #       v # |
|                                                                   #                    #       v   |
|                                                                   #                    #       v#  |
|                                                                   #                            v   |
|                                                                               ############     v   |
|                    ##########################################################                  /   |
|                                                                                               B    |
|                                                                                                    |
+----------------------------------------------------------------------------------------------------+