+--------------------+
|                B#  |
|         #     /#   |
|  #       #   /#    |
|        #  # /#     |
|         #  #^<     |
|  #       #  #^<    |
|   #       #  #^    |
|    #       #  ^    |
|     #       # ^    |
|      #       #^<   |
|       #       #^<  |
|     #  #   #   #^< |
|      #  #       #^ |
|       #  #    A>/  |
|        #  #        |
| #       #          |
| #        #     #   |
|           #  #  #  |
|    ####          # |
|                    |
+--------------------+